########################################################################################################
########################################################################################################
########################################################################################################
########################################################################################################
#############################...............................................############################
#############################............&.............$..........$.........############################
#############################...............................................############################
#############################.....#################################.........############################
##############################.......................##.....................############################
##############################.......................##.....................############################
##############################..........$............##.....................############################
################################..^..^...............##........$........$...############################
##########################################...........##.....................############################
############################..#..#.......$.....########..$..############################################
############################.................##########.....................############################
############################.@....$...$....############...................*.############################
############################.............###############....................############################
########################################################################################################
########################################################################################################
########################################################################################################
########################################################################################################
########################################################################################################
########################################################################################################