########################################################################################################
########################################################################################################
########################################################################################################
########################################################################################################
#############################...............................................############################
#############################...............................................############################
#############################...............................................############################
#############################.............&............$.........$..........############################
#############################...............................................############################
#############################.....#################################.........############################
##############################.......................##.....................############################
##############################..........$............##.....................############################
##############################.......................##.....................############################
#################################..^..^..............##........$.....$......############################
##########################################...........##..................^..############################
############################..#..#.......$.....########.....############################################
############################.................##########.....................############################
############################.@....$...$....############.$.........$.......*.############################
############################.............##############.....................############################
########################################################################################################
########################################################################################################
########################################################################################################
########################################################################################################
########################################################################################################
########################################################################################################
########################################################################################################
########################################################################################################
########################################################################################################
########################################################################################################