########################################################################################################
########################################################################################################
########################################################################################################
########################################################################################################
########################################################################################################
########################################################################################################
########################################################################################################
########################################################################################################
########################################################################################################
###################..............................................................#######################
###################..............................................................#######################
###################.................$..............$............$................#######################
###################..@........................................................*..#######################
###################..............................................................#######################
####################################..##################################################################
####################################..##################################################################
####################################..##################################################################
####################################..##################################################################
####################################..##################################################################
####################################..##################################################################
####################################^^##################################################################
########################################################################################################
########################################################################################################
########################################################################################################
########################################################################################################