########################################################################################################
########################################################################################################
########################################################################################################
########################################################################################################
#############################...............................................############################
#############################.............$.................................############################
#############################...............................................############################
#############################.....#################################.........############################
##############.......................................##.....................############################
##############....................$.....$........$......................################################
##############...$....................................................##....############################
##############.................#########################.............#......############################
#####################................................##....................$############################
###########################....................########.....############################################
############################.................##########.....................############################
############################.@....$...$....#############..................*.############################
############################.............###############....................############################
########################################################################################################
########################################################################################################
########################################################################################################
########################################################################################################
########################################################################################################
########################################################################################################
########################################################################################################